#########################
#       1          2    #
#       #   $   #       ##
#  ###########  #    $   #
##      #       ##    ####
 #      #        ######
 #      ##         #
 ##                #
  ## ######## ##  ##
   ##             .#
   #.        #######
   ###########
