#######################################################
#        2                 #   ###                    #
# $                           #  #                    #
### ########################  #          1  #  $      #
#   #                      # ##  ###########.   $    #
#                          # ##  #         .##########
#   ################### #  #     #  ########    #    #
#   #       #         # #  #  #  #  #      #  $ # #  #
#   #                 # #########   #  .   #  ### #  #
#   #       # #                            #    # #  #
#   #         #       # ########### #              $ #
#   ######### #       # #  $   $    #######  #  # ####
#             #       # #           #        # #      #
#   ########  #########  ############        #.#  $   #
####        ##.          #           #... $  #.#     #
              ###########             ####### #######